1111111111111
1S00100010001
1110111011101
1000001000101
1011101110101
1010000010101
1010111110101
1000000000101
1111111110101
1000000000001
1011111111101
1000000000001
11111111110Z1